C 225,30,0
NO ./textures/texture_wall.xpm
SO ./textures/texture_wall.xpm
WE ./textures/texture_wall.xpm
EA ./textures/texture_wall.xpm



F 220 , 100 , 0

        111111111111111111111111
        1000000000110000000000001
        1011000001110000000000001
        1001000000000000000000001
111111111011000001110000000000001
100000000011000001110111111111111
11110111111111011100000010001
11110111111111011101010010001
11000000110101011100000010001
10000000000000011000000100N01
10000000000000001101010010001
110000011101010111110111100111
11110111 1110101 101111010001
 1111    1111111111 111111111111
