NO ./path_to_the_north_texture
SO 			./path_to_the_south_texture
WE ./path_to_the_west_texture
EA ./path_to_the_east_texture




F 220	,100,	0
C  	225,30,0


     11111111      1111111111111111111 1
 111100000001111  111000000000000000101
     111110000111 111111000000000001111
      11110011011100000000111111111
111111000000000000000000000000001
1     11000000000000000000000011111
11   10000000000000N0000000111
  1  1000000000000000011111
   11 1111111111111111