NO ./textures/NO_example_path


C 34,0,78

WE ./textures/WE_example_path
F 200,150,122
SO ./textures/SO_example_path
EA ./textures/EA_example_path



11111111111111111      11111111111111111111111111111
      1111      11111111111                        1111111
    1110001111    11100001111111                         111111
       1100000111111000011110011111111111111            1101
         111000000000010011101111000000000111111      11110011
            111111111000000W0011000001111000000111  111100001
                     111111100000000000000011100011     1101111111
       111111111111111000000001111100000011111101    111000111111
   11111             11000001111   111000000000011  11000111
  11              11110001100001111000001111110001111000001
  1              11  11100000111111111000001000111  111110111
   11111    1   111111  11110111110000001110010000111000001
       11111            11  111   11111000001 111000001111
                  1111111     11       11111    1111011
           1111111111           1   1      1111111111
