NO ./path_to_the_north_texture


C 34,0,78


WE ./path_to_the_west_texture
F 200,150,122'
SO ./path_to_the_south_texture
EA ./path_to_the_east_texture




11111111111111111      11111111111111111111111111111
      1111      11111111111                        1111111
    1110001111    11100001111111                         111111
       1100000111111000011110011111111111111             1101
         111000000000S10011101111000000000111111      11110011
            11111111100000000011000001111000000111  111100001
                     111111100000000000000011100011     11011111111
       111111111111111000000001111100000011111101    111000111111
   11111             11000001111   111000000000011  11000111
  11              11110001100001111000001111110001111000001
  1              11  11100000111111111000001000111  111110111
   11111    1   111111  11110111110000001110010000111000001
       11111            11  111   11111000001 111000001111
                  1111111     11       11111    1111011
           1111111111           1   1      1111111111