SO ./textures/wall.xpm
NO ./textures/wall1.xpm
WE ./textures/wall2.xpm
EA ./textures/wall3.xpm

F 150, 180, 190
C 104, 106, 108

        1111111111111111111111111
        1000000000110000000000001
        1001000000000000000000001
111111111011000001110000000000001
111000000011000001110111111111111
11110111111111011100000010001
11111111111111011101010010001
11000000110100011100000000001
10E00000000000110000000000001
10000000000000000011010100011
11000001111010111110111100111
11110111 1111101 101111010001
11111111 1111111 111111111111